00000000000000000000
00000000000000000000
00000000000000000000
00000011111111100000
00001000000000010000
00010000000000100000
00100000000001000000
01111111111110000000
00000000000000000000
00000000000000000000
00000000000000000000
00000000000000000000
00000000000000000000
00000000000000000000