----------------
----------------
-D-D---D-D------
-DGD---DGD------
-DbD---DbD------
-DDD---DDD------
----------------
---PbbbO--------
---PGBGO--------
---PBGBO--------
---PGBGO--------
---PBGBO--------
---PbbbO--------
----------------
----------------
----------------
----------------
----------------
----------------
----------------
