----------------
----------------
----------------
----------------
-EEEEEEEEEEEEEE-
-E------------E-
-E--EEEEEEEE--E-
-E--E------E--E-
-E--E--EE--E--E-
-E--E--EE--E--E-
-E--E------E--E-
-E--EEEEEEEE--E-
-E------------E-
-EEEEEEEEEEEEEE-
----------------
----------------
----------------
----------------
----------------
----------------
