----------------
----------------
----------------
----------------
EEEEEEEEEEEEEEEE
RRRRRRRRRRRRRRRR
YYYYYYYYYYYYYYYY
LLLLLLLLLLLLLLLL
PPPPPPPPPPPPPPPP
GGGGGGGGGGGGGGGG
----------------
----------------
----------------
----------------
----------------
----------------
----------------
----------------
----------------
----------------
