0000000000000000
0000000000000000
0000000000000000
0000000000000000
1111111111111111
7777777777777777
2222222222222222
8888888888888888
9999999999999999
4444444444444444
0000000000000000
0000000000000000
0000000000000000
0000000000000000
0000000000000000
0000000000000000
