----------------
----------------
-------DD-------
----WWW--WWW----
-WWW---DD---WWW-
W---OOO--OOO---W
-OOO---DD---OOO-
O---GGG--GGG---O
-GGG---DD---GGG-
G---RRR--RRR---G
-RRR---DD---RRR-
R---bbb--bbb---R
-bbb---DD---bbb-
b---GGG--GGG---b
-GGG--------GGG-
G--------------G
----------------
----------------
----------------
----------------
