----------------
----------------
----------------
----------------
YYYYYYYYYYYYYYYY
YYYYYYYYYYYYYYYY
----------------
----------------
RRRD-DRRRRD-DRRR
RRRD-DRRRRD-DRRR
RRRD-DRRRRD-DRRR
RRRD-DRRRRD-DRRR
----------------
----------------
WWWWWWWWWWWWWWWW
WWWWWWWWWWWWWWWW
----------------
----------------
----------------
----------------
