----------------
----------------
----------------
RRRRRRRRRRRRRRRR
RRRRRRRRRRRRRRRR
GGGGGGGGGGGGGGGG
GGGGGGGGGGGGGGGG
LLLLLLLLLLLLLLLL
LLLLLLLLLLLLLLLL
DDDDDDEEEEDDDDDD
DRRRRD----DLLLLD
DRRRRD----DLLLLD
D--------------D
D--------------D
D----DGGGGD----D
D----DGGGGD----D
D----DGGGGD----D
DEEEEDDDDDDEEEED
----------------
----------------
