----------------
----------------
----------------
R--DOOOOOOOOD--R
R--DDOOOOOODD--R
R--D-DOOOOD-D--R
R--D--DOOD--D--R
R--D--GEEG--D--R
R--D--G--G--D--R
R--D--G--G--D--R
R--D--G--G--D--R
R--D--G--G--D--R
RDDDDDG--GDDDDDR
----------------
----------------
----------------
----------------
----------------
----------------
----------------
