----------------
----------------
----------------
----------------
----------------
---EOGP--OGLE---
---LGOR--GOEL---
---GPRO--LEOG---
---ORPG--ELGO---
---ROGL--OGPR---
---PGOE--GORP---
---GLEO--PROG---
---OELG--RPGO---
---EOGP--OGLE---
---LGOR--GOEL---
---GPRO--LEOG---
---ORPG--ELGO---
---ROGL--OGPR---
---PGOE--GORP---
----------------