----------------
----------------
----------------
----------------
----------------
----------------
-------WW-------
------WWWW------
------WWWWW-----
-----WWWWWW-----
-----WWLWWW-----
-----WLLWLWW----
----WLLLWLWW----
----LLLLWLLLW---
---LLLLLLLLLL---
--LLLLLLLLLLLL--
--LLLLLLLLLLLL--
-LLLLLLLLLLLLLL-
LLLLLLLLLLLLLLLL
LLLLLLLLLLLLLLLL
