0000000000000000
0000000000000000
0000000000000000
0000001110000000
0000001110000000
0000001110000000
0000001110000000
0000001110000000
0000003130000000
0000003130000000
0000000000000000
0000000000000000
0000000000000000
0000000000000000
0000000000000000
0000000000000000
