----------------
----------------
----------------
----------------
Y---------------
YPb-------------
YPbRG-----------
YPbRGBO---------
YPbRGBOWY-------
YPbRGBOWYPL-----
YPbRGBOWYPLRG---
YPbRGBOWYPLRGbO-
DEbRGBOWYPLRGbOW
--DEGBOWYPLRGbOW
----DEOWYPLRGbOW
------DEYPLRGbOW
--------DELRGbOW
----------DEGbOW
------------DEOW
--------------DE
