----------------
----------------
-----O---O------
------O-O-------
------O-O-------
-----EEEEE------
-----EEEEE------
----EEREREE-----
----EEREREE-----
---EEEEEEEEE----
---EEEEEEEEE----
---E-EEEEE-E----
---E-E---E-E----
---E-E---E-E----
------E-E-------
------E-E-------
----------------
----------------
----------------
----------------
