0000000000000000
0000000000000000
1000000000000000
1600000000000000
1630000000000000
1634000000000000
1634700000000000
1634780000000000
1634789000000000
1634789200000000
1634789210000000
1634789216000000
1634789216300000
1634789216340000
1111111111117000
0000000000000000
