----------------
----------------
----------------
----------------
YYYYYYD--DYYYYYY
PPPPPPD--DPPPPPP
DDWWDDD--DDDWWDD
LLLLLLD--DLLLLLL
RRRRRRD--DRRRRRR
GGGGGGD--DGGGGGG
EEWWEED--DEEWWEE
BBBBBBD--DBBBBBB
OOOOOOD--DOOOOOO
WWWWWWD--DWWWWWW
WWWWWWD--DWWWWWW
----------------
----------------
----------------
----------------
----------------
