----------------
----------------
----------------
BEEEBBBBBBBBEEEB
BEOOEEBBBBEEGGEB
BEOOOOEBBEGGGGEB
BEOOOOOEEGGGGGEB
BEOOOOOEEGGGGGEB
BEOOOOOEEGGGGGEB
BEOOOOOEEGGGGGEB
BEOOOOOEEGGGGGEB
BEOOOOOEEGGGGGEB
BBEOOOOEEGGGGEBB
BBBEOOOEEGGGEBBB
BBBBEEOEEGEEBBBB
BBBBBBEEEEBBBBBB
----------------
----------------
----------------
----------------
