----------------
----------------
----------------
----------------
----------------
--OO--WWWW--OO--
--WW--OOOO--WW--
--LL--RRRR--LL--
--PP--GGGG--PP--
--GG--PPPP--GG--
--RR--LLLL--RR--
--OO--WWWW--OO--
--WW--OOOO--WW--
----------------
----------------
----------------
----------------
----------------
----------------
----------------
