----------------
----------------
----------------
L-R-Y-G-G-Y-R--L
L-R-Y-G-G-Y-R--L
L-R-Y-G-G-Y-R--L
L-DODODODODOD--L
L-R-Y-G-G-Y-R--L
L-R-Y-G-G-Y-R--L
L-R-Y-G-G-Y-R--L
L-R-Y-G-G-Y-R--L
L-R-Y-G-G-Y-R--L
O-D-D-D-D-D-D--O
L-R-Y-G-G-Y-R--L
----------------
----------------
----------------
----------------
----------------
----------------
