----------------
----------------
----------------
---DEEED--------
--D-----D-------
-D--BBB--D------
D--BBBBB--D-----
D-GGGGGGG-D-----
D-GGGGGGG-D-----
D-GGGGGGG-D-----
D-LLLLLLL-D-----
D-LLLLLLL-D-----
D--PPPPP--D-----
-D--PPP--D------
--D-----D-------
---DDDDD--------
----------------
----------------
----------------
----------------
