11110000000000000000
00000000000000000000
00000000000000000000
00000000000000000000
00000000000000000000
00000000000000000000
00000111111111100000
00000111111111100000
00000111111111100000
00000111110111100000
00000111110111100000
00000111111111100000
00000111111111100000
00000000000000000000
00000000000000000000