----------------
----------------
----------------
----DDDDDDDDD---
----GRRLDLRRG---
----GRRLDLRRG---
----GRRLDLRRG---
----GRRLDLRRG---
----GRRLDLRRG---
----GRRLDLRRG---
----GRRLDLRRG---
----DDDDDDDDD---
----------------
----------------
----------------
----------------
----------------
----------------
----------------
----------------
