----------------
----------------
DDDDDDDDDDDDDDDD
------D-----DO--
------D-----D---
--DG--D-----D---
--D---D---D-D---
--D---D---D-D---
--D---DG--D-D---
--D--OD---DLD---
--D---DR--D-D---
--D---D---D-D---
--D---D---D-D---
--DL------D-----
--D-------D----O
--DDDDDDDDDDDDDD
----------------
----------------
----------------
----------------