----------------
----------------
-------EE-------
----LLLEEGGG----
--LLLLWWWWGGGG--
-LLLWWWWWWWWGGG-
-LLWWWWWWWWWWGG-
-LLWWWWWWWWWWGG-
-E-E-E-EE-E-E-E-
-------EE-------
---DD--EE-------
---DD--DD-------
----DDDDD-------
-----DDD--------
----------------
----------------
----------------
----------------
----------------
----------------
