----------------
----------------
----------------
REEEEEEEEEEEEEER
O--------------O
LLLLLLLLLLLLLLLL
----------------
REEEEEEEEEEEEEER
O--------------O
LLLLLLLLLLLLLLLL
----------------
LEEEEEEEEEEEEEEL
O--------------O
RRRRRRRRRRRRRRRR
----------------
----------------
----------------
----------------
----------------
----------------
