----------------
----------------
----------------
GGDRRDLLDGGDPPDO
PPDEEDEEDEEDEEDL
---PP-----------
--D--DPPD--D--D-
--D--D--DPPD--D-
--D--D--D--D--D-
------------PP--
--D--D--DPPD--D-
--D--DPPD--D--D-
--DPPD--D--D----
PP--------------
----------------
----------------
----------------
----------------
----------------
----------------
