00000000000000000000
00000000000000000000
00000000000000000000
00000000000000000000
11111111111111111111
77777777777777777777
88888888888888888888
22222222222222222222
99999999999999999999
44444444444444444444
00000000000000000000
00000000000000000000
00000000000000000000
00000000000000000000
00000000000000000000

