1111000000000000
0000000000000000
0000000000000000
0000000000000000
0000000000000000
0000000000000000
0111111111111110
0111111111111110
0111100000111110
0111100000111110
0111100000111110
0111111111111110
0111111111111110
0000000000000000
0000000000000000
1111111111111111