----------------
----------------
----------------
---D-D-D-D-D-D--
---D-D-D-D-D-D--
---D-D-D-D-DBB--
---D-D-D-D-D-D--
---D-D-D-DGGGG--
---D-D-D-D-D-D--
---D-D-DRRRRRR--
---D-D-D-D-D-D--
---D-DLLLLLLLL--
---D-D-D-D-D-D--
---DPPPPPPPPPP--
---D-D-D-D-D-D--
---YYYYYYYYYYY--
---EEEEEEEEEEE--
----------------
----------------
----------------
