----------------
----------------
----------------
----------------
----------------
----------------
----------------
----------------
----------------
----------------
----------------
----------------
EEEEEEEEEEEEEEEE
YYYYYYYYYYYYYYYY
EEEEEEEEEEEEEEEE
----------------
----------------
EEEEEEEEEEEEEEEE
RRRRRRRRRRRRRRRR
EEEEEEEEEEEEEEEE
