----------------
----------------
----------------
----------------
-DOOOOOOOOOOOOD-
-D------------D-
-D--DDDDDDDD--D-
-D--D------D--D-
-D--D-RRRR-D--D-
-D--D-GGGG-D--D-
-D--D-LLLL-D--D-
-D--D-WWWW-D--D-
-D--D------D--D-
-D--DBBBBBBD--D-
-D------------D-
-DDDDDDDDDDDDDD-
----------------
----------------
----------------
----------------
