----------------
----------------
----------------
----------------
----------------
----------------
G-R-b-P-L-O-W-P-
E-E-E-E-E-E-E-E-
-L-R-G-B-G-Y-W-B
-E-E-E-E-E-E-E-E
B-G-R-b-P-L-O-W-
E-E-E-E-E-E-E-E-
-P-L-R-G-B-G-Y-W
-E-E-E-E-E-E-E-E
O-B-G-R-b-P-L-O-
E-E-E-E-E-E-E-E-
-Y-P-L-R-G-B-G-Y
-E-E-E-E-E-E-E-E
W-O-B-G-R-b-P-L-
E-E-E-E-E-E-E-E-
