----------------
----------------
----------------
GGGGGGGGGGGGGGGG
----------------
WWWDDDDDDDDDDDDD
----------------
RRRRRRRRRRRRRRRR
----------------
DDDDDDDDDDDDDWWW
----------------
PPPPPPPPPPPPPPPP
----------------
LLLDDDDDDDDDDDDD
----------------
BBBBBBBBBBBBBBBB
----------------
DDDDDDDDDDDDDBBB
----------------
----------------
