----------------
----------------
----------------
----------------
BBBBBBBBBBBBBBBB
----------------
--EEEE-EEEE-EEEE
--EGGE-EGGE-EGGE
--EGGE-EGGE-EGGE
--EEEE-EEEE-EEEE
----------------
-EEEE-EEEE-EEEE-
-ERRE-ERRE-ERRE-
-ERRE-ERRE-ERRE-
-EEEE-EEEE-EEEE-
----------------
EEEE-EEEE-EEEE--
EbbE-EbbE-EbbE--
EbbE-EbbE-EbbE--
EEEE-EEEE-EEEE--
