----------------
----------------
W---------------
WO--------------
WOB-------------
WOBG------------
WOBGR-----------
WOBGRL----------
WOBGRLP---------
WOBGRLPY--------
WOBGRLPYW-------
WOBGRLPYWO------
WOBGRLPYWOB-----
WOBGRLPYWOBG----
EEEEEEEEEEEER---
----------------
----------------
----------------
----------------
----------------