----------------
----------------
------YYPP------
-----YYYPPb-----
----YYYPPPbR----
---YYYPPPbbRG---
---YYPPPbbRRG---
--YYPPPbbRRGGB--
--YPPPbbRRGGBB--
--PPPbbRRGGBBO--
--bbbbRRGGBBOO--
--bbRRRGGBBBOW--
--RRRRGGBBBOOW--
--RRRGGBBBOOW---
---GGGBBBOOW----
----BBBOOOW-----
-----OOOWWW-----
------OOWW------
----------------
----------------
