---D------------
---D------------
----------------
----------------
---D------------
---D------------
---D------b-----
---D-----bBb----
---D----bBbBb---
---D---bBbEbBb--
---D----bBbBb---
---D-----bBb----
---D------b-----
---D------------
---D------------
---DDDDDDDDDDDDD
----------------
----------------
----------------
----------------
