----------------
----------------
----------------
LLLLLLLLLLLLLLLL
LDDDDPPDDPPDDDDL
LD------------DL
LDP----------PDL
LLPP--------PPLL
-LDPP------PPDL-
--LPP------PPL--
--LDPP----PPDL--
---LPPP--PPPL---
---LDPP--PPDL---
----LPPPPPPL----
----LDPPPPDL----
-----LPPPPL-----
-----LDPPDL-----
------LPPL------
-------LL-------
-------LL-------
